//MAP CONVERTED BY dmm2tgm.py THIS HEADER COMMENT PREVENTS RECONVERSION, DO NOT REMOVE
"a" = (
/turf/template_noop,
/area/template_noop)
"c" = (
/obj/random/firstaid,
/turf/simulated/floor/tiled/steel/bluecorner,
/area/template_noop)
"d" = (
/obj/random/material/low_chance,
/turf/simulated/floor/tiled/steel/bluecorner,
/area/template_noop)
"j" = (
/turf/simulated/floor/tiled/steel/bluecorner,
/area/template_noop)
"r" = (
/obj/item/remains,
/turf/simulated/floor/tiled/steel/bluecorner,
/area/template_noop)
"v" = (
/obj/random/mob/space_legion,
/turf/simulated/floor/tiled/steel/bluecorner,
/area/template_noop)
"D" = (
/obj/random/cluster/xenomorphs,
/turf/simulated/floor/tiled/steel/bluecorner,
/area/template_noop)
"J" = (
/obj/random/scrap/sparse_even,
/turf/simulated/floor/tiled/steel/bluecorner,
/area/template_noop)
"N" = (
/obj/machinery/door/airlock/command,
/turf/simulated/floor/tiled/steel/bluecorner,
/area/template_noop)
"R" = (
/obj/random/techpart/low_chance,
/turf/simulated/floor/tiled/steel/bluecorner,
/area/template_noop)
"T" = (
/obj/random/structures/low_chance,
/turf/simulated/floor/tiled/steel/bluecorner,
/area/template_noop)
"V" = (
/obj/random/ammo,
/obj/structure/table/rack,
/turf/simulated/floor/tiled/steel/bluecorner,
/area/template_noop)
"W" = (
/turf/simulated/wall/r_wall,
/area/template_noop)

(1,1,1) = {"
a
a
a
a
a
a
a
a
a
a
a
a
a
a
a
a
a
a
a
a
a
a
a
a
a
"}
(2,1,1) = {"
a
a
a
a
a
a
a
a
a
a
a
a
a
a
a
a
a
a
a
a
a
a
a
a
a
"}
(3,1,1) = {"
a
a
a
a
a
a
a
a
a
a
a
a
a
a
a
a
a
a
a
a
a
a
a
a
a
"}
(4,1,1) = {"
a
a
a
a
a
a
a
W
W
N
W
W
N
W
W
a
a
a
a
a
a
a
a
a
a
"}
(5,1,1) = {"
a
a
a
a
a
a
a
W
W
j
W
W
j
W
W
a
a
a
a
a
a
a
a
a
a
"}
(6,1,1) = {"
a
a
a
W
W
W
W
W
W
j
W
W
j
W
W
W
W
W
W
W
a
a
a
a
a
"}
(7,1,1) = {"
a
a
a
W
W
W
W
W
W
N
W
W
N
W
W
W
W
W
W
W
a
a
a
a
a
"}
(8,1,1) = {"
a
a
a
W
W
j
j
j
D
j
W
W
j
j
j
T
T
T
W
W
a
a
a
a
a
"}
(9,1,1) = {"
a
a
a
W
W
j
v
j
j
j
W
W
V
j
j
j
v
j
W
W
a
a
a
a
a
"}
(10,1,1) = {"
a
a
a
W
W
j
R
j
j
T
W
W
V
j
j
j
j
R
W
W
a
a
a
a
a
"}
(11,1,1) = {"
a
a
a
W
W
j
j
j
v
T
W
W
V
v
j
j
j
j
W
W
a
a
a
a
a
"}
(12,1,1) = {"
a
a
a
W
W
j
v
j
j
j
W
W
J
j
j
R
j
D
W
W
a
a
a
a
a
"}
(13,1,1) = {"
a
a
a
W
W
W
W
W
W
W
W
W
W
W
W
W
W
W
W
W
a
a
a
a
a
"}
(14,1,1) = {"
a
a
a
W
W
j
j
D
j
j
J
J
J
j
j
d
j
j
W
W
a
a
a
a
a
"}
(15,1,1) = {"
a
a
a
W
W
j
j
j
j
j
j
j
j
j
j
j
j
j
W
W
a
a
a
a
a
"}
(16,1,1) = {"
a
a
a
W
W
j
j
j
v
j
j
v
J
j
j
v
j
j
W
W
a
a
a
a
a
"}
(17,1,1) = {"
a
a
a
W
W
j
R
j
j
J
j
j
j
v
j
j
D
j
W
W
a
a
a
a
a
"}
(18,1,1) = {"
a
a
a
W
W
j
j
j
j
j
j
j
d
j
j
j
j
d
W
W
a
a
a
a
a
"}
(19,1,1) = {"
a
a
a
W
W
W
W
N
W
W
W
N
W
W
W
N
W
W
W
W
a
a
a
a
a
"}
(20,1,1) = {"
a
a
a
W
W
W
c
j
j
W
D
j
j
W
D
j
R
W
W
W
a
a
a
a
a
"}
(21,1,1) = {"
a
a
a
a
W
W
j
j
j
W
j
r
j
W
j
j
j
W
W
a
a
a
a
a
a
"}
(22,1,1) = {"
a
a
a
a
W
W
D
j
T
W
c
j
T
W
j
j
T
W
W
a
a
a
a
a
a
"}
(23,1,1) = {"
a
a
a
a
W
W
W
W
W
W
W
W
W
W
W
W
W
W
W
a
a
a
a
a
a
"}
(24,1,1) = {"
a
a
a
a
W
W
W
W
W
W
W
W
W
W
W
W
W
W
W
a
a
a
a
a
a
"}
(25,1,1) = {"
a
a
a
a
a
a
a
a
a
a
a
a
a
a
a
a
a
a
a
a
a
a
a
a
a
"}
