//MAP CONVERTED BY dmm2tgm.py THIS HEADER COMMENT PREVENTS RECONVERSION, DO NOT REMOVE
"a" = (
/turf/template_noop,
/area/template_noop)
"c" = (
/obj/effect/window_lwall_spawn/smartspawn,
/turf/simulated/floor/tiled/steel/gray_perforated,
/area/template_noop)
"i" = (
/turf/simulated/floor/tiled/steel/gray_perforated,
/area/template_noop)
"j" = (
/obj/structure/bed/chair,
/turf/simulated/floor/tiled/steel/gray_perforated,
/area/template_noop)
"x" = (
/turf/simulated/wall/r_wall,
/area/template_noop)
"H" = (
/obj/item/modular_computer/console{
	dir = 1
	},
/turf/simulated/floor/tiled/steel/gray_perforated,
/area/template_noop)
"N" = (
/obj/structure/table/standard,
/obj/item/folder/blue,
/turf/simulated/floor/tiled/steel/gray_perforated,
/area/template_noop)
"Z" = (
/obj/machinery/door/airlock/glass_security{
	name = "Airlock";
	req_access = list(1)
	},
/turf/simulated/floor/tiled/steel/gray_perforated,
/area/template_noop)

(1,1,1) = {"
a
a
a
a
a
"}
(2,1,1) = {"
x
c
c
x
a
"}
(3,1,1) = {"
x
i
N
c
a
"}
(4,1,1) = {"
Z
j
H
c
a
"}
(5,1,1) = {"
x
x
x
x
a
"}
