//MAP CONVERTED BY dmm2tgm.py THIS HEADER COMMENT PREVENTS RECONVERSION, DO NOT REMOVE
"aa" = (
/turf/simulated/floor/beach/water/coastwater{
	dir = 7
	},
/area/precursor)
"ab" = (
/turf/simulated/wall/r_wall,
/area/precursor)
"ac" = (
/turf/simulated/floor/beach/water/ocean,
/area/precursor)
"ad" = (
/obj/machinery/light{
	dir = 4;
	icon_state = "tube1"
	},
/turf/simulated/floor/beach/water/shallow,
/area/precursor)
"ae" = (
/obj/structure/catwalk,
/obj/structure/disposalpipe/segment{
	dir = 4;
	icon_state = "pipe-c"
	},
/turf/simulated/floor/beach/water/shallow,
/area/precursor)
"af" = (
/obj/structure/catwalk,
/obj/structure/disposalpipe/segment{
	icon_state = "pipe-s";
	dir = 4
	},
/turf/simulated/floor/beach/water/shallow,
/area/precursor)
"ag" = (
/obj/structure/disposalpipe/segment{
	icon_state = "pipe-s";
	dir = 4
	},
/obj/structure/catwalk,
/turf/simulated/floor/beach/water/shallow,
/area/precursor)
"ah" = (
/obj/structure/catwalk,
/obj/structure/disposalpipe/segment{
	dir = 2;
	icon_state = "pipe-c"
	},
/obj/random/mob/psi_monster/low_chance,
/turf/simulated/floor/beach/water/shallow,
/area/precursor)
"ai" = (
/obj/structure/catwalk,
/obj/structure/disposalpipe/segment,
/turf/simulated/floor/beach/water/shallow,
/area/precursor)
"aj" = (
/obj/structure/barricade,
/turf/simulated/floor/tiled/dark/gray_platform,
/area/precursor)
"ak" = (
/obj/structure/barricade,
/obj/structure/disposalpipe/segment,
/turf/simulated/floor/tiled/dark/gray_platform,
/area/precursor)
"al" = (
/obj/random/pack/machine,
/turf/simulated/floor/beach/water/shallow,
/area/precursor)
"am" = (
/obj/structure/disposalpipe/segment{
	dir = 4;
	icon_state = "pipe-c"
	},
/turf/simulated/floor/beach/water/shallow,
/area/precursor)
"an" = (
/obj/structure/disposalpipe/segment{
	dir = 8;
	icon_state = "pipe-c"
	},
/turf/simulated/floor/beach/water/shallow,
/area/precursor)
"ao" = (
/obj/structure/disposalpipe/segment{
	dir = 1;
	icon_state = "pipe-c"
	},
/turf/simulated/floor/plating/under,
/area/precursor)
"ap" = (
/obj/structure/disposalpipe/segment{
	dir = 2;
	icon_state = "pipe-c"
	},
/turf/simulated/floor/plating/under,
/area/precursor)
"aq" = (
/obj/effect/window_lwall_spawn/reinforced,
/obj/structure/disposalpipe/segment,
/turf/simulated/floor/plating,
/area/precursor)
"ar" = (
/obj/random/mob/carp/low_chance,
/turf/simulated/floor/rock/manmade/ruin1,
/area/precursor)
"as" = (
/turf/simulated/floor/rock/manmade/ruin1,
/area/precursor)
"at" = (
/obj/structure/disposalpipe/segment,
/obj/structure/catwalk,
/turf/simulated/floor/plating/under,
/area/precursor)
"au" = (
/turf/simulated/wall/rust_reinforced,
/area/precursor)
"av" = (
/obj/machinery/light{
	dir = 8
	},
/obj/random/mob/psi_monster/low_chance,
/turf/simulated/floor/beach/water/shallow,
/area/precursor)
"aw" = (
/obj/structure/disposalpipe/segment,
/obj/random/mob/psi_monster/low_chance,
/turf/simulated/floor/beach/water/shallow,
/area/precursor)
"ax" = (
/obj/machinery/artifact,
/turf/simulated/floor/bluegrid,
/area/precursor)
"ay" = (
/obj/structure/disposalpipe/segment{
	icon_state = "pipe-s";
	dir = 4
	},
/obj/structure/catwalk,
/obj/machinery/light{
	dir = 1
	},
/obj/random/mob/psi_monster/low_chance,
/turf/simulated/floor/beach/water/shallow,
/area/precursor)
"az" = (
/obj/machinery/button/remote/blast_door{
	dir = 2;
	id = "deep_maint_AI_core";
	name = "AI Core Door Control";
	pixel_x = 0;
	pixel_y = -24
	},
/turf/simulated/floor/beach/water/ocean,
/area/precursor)
"aA" = (
/obj/structure/disposalpipe/segment{
	dir = 1;
	icon_state = "pipe-c"
	},
/obj/structure/catwalk,
/turf/simulated/floor/beach/water/shallow,
/area/precursor)
"aB" = (
/obj/structure/disposalpipe/segment{
	dir = 2;
	icon_state = "pipe-c"
	},
/obj/structure/catwalk,
/turf/simulated/floor/beach/water/shallow,
/area/precursor)
"aC" = (
/obj/machinery/door/blast/shutters{
	dir = 2;
	id = "deep_maint_AI_core";
	name = "AI Core"
	},
/turf/simulated/floor/tiled/dark/cargo,
/area/precursor)
"aD" = (
/obj/structure/disposalpipe/segment{
	dir = 4;
	icon_state = "pipe-c"
	},
/obj/structure/catwalk,
/turf/simulated/floor/beach/water/shallow,
/area/precursor)
"aE" = (
/obj/structure/disposalpipe/segment{
	dir = 8;
	icon_state = "pipe-c"
	},
/obj/structure/catwalk,
/turf/simulated/floor/beach/water/shallow,
/area/precursor)
"aF" = (
/obj/structure/railing{
	tag = "icon-railing0 (EAST)";
	icon_state = "railing0";
	dir = 4;
	anchored = 1
	},
/obj/random/mob/psi_monster/low_chance,
/turf/simulated/floor/plating/under,
/area/precursor)
"aG" = (
/obj/structure/catwalk,
/turf/simulated/floor/plating/under,
/area/precursor)
"aH" = (
/obj/structure/railing{
	tag = "icon-railing0 (WEST)";
	icon_state = "railing0";
	dir = 8
	},
/obj/random/mob/psi_monster/low_chance,
/turf/simulated/floor/holofloor/beach/sand,
/area/precursor)
"aI" = (
/obj/machinery/door/blast/shutters{
	dir = 2;
	id = "deep_maint_AI_core";
	name = "AI Core"
	},
/turf/simulated/floor/holofloor/beach/sand,
/area/precursor)
"aJ" = (
/obj/structure/disposalpipe/segment{
	icon_state = "pipe-s";
	dir = 4
	},
/turf/simulated/wall/r_wall,
/area/precursor)
"aK" = (
/obj/random/junk,
/turf/simulated/floor/beach/water/shallow,
/area/precursor)
"aL" = (
/obj/machinery/light{
	dir = 8
	},
/turf/simulated/floor/beach/water/shallow,
/area/precursor)
"aM" = (
/obj/structure/table/reinforced,
/obj/random/pack/tech_loot,
/obj/random/pack/tech_loot,
/obj/random/pack/tech_loot/low_chance,
/obj/random/pack/tech_loot/low_chance,
/turf/simulated/floor/beach/water/shallow,
/area/precursor)
"aN" = (
/obj/random/pack/machine,
/turf/simulated/floor/tiled/techmaint_cargo,
/area/precursor)
"aO" = (
/obj/random/junk,
/turf/simulated/floor/holofloor/beach/sand,
/area/precursor)
"aP" = (
/obj/structure/catwalk,
/obj/structure/disposalpipe/segment{
	icon_state = "pipe-s";
	dir = 4
	},
/obj/machinery/light,
/turf/simulated/floor/beach/water/shallow,
/area/precursor)
"aQ" = (
/obj/random/junk,
/obj/random/junk,
/turf/simulated/floor/plating/under,
/area/precursor)
"aR" = (
/obj/random/junk,
/turf/simulated/floor/plating/under,
/area/precursor)
"aS" = (
/obj/random/scrap/dense_even,
/turf/simulated/floor/plating/under,
/area/precursor)
"aT" = (
/obj/structure/barricade,
/turf/simulated/floor/beach/water/shallow,
/area/precursor)
"aU" = (
/obj/structure/table/reinforced,
/obj/random/pack/rare,
/obj/random/pack/rare,
/obj/random/pack/rare/low_chance,
/obj/random/pack/rare/low_chance,
/obj/random/dungeon_armor_mods,
/obj/random/dungeon_gun_mods,
/obj/random/dungeon_gun_mods,
/turf/simulated/floor/beach/water/ocean,
/area/precursor)
"aV" = (
/obj/item/remains/human,
/obj/random/pack/cloth,
/obj/random/pack/cloth,
/obj/random/pack/gun_loot,
/obj/random/pack/gun_loot,
/turf/simulated/floor/beach/water/ocean,
/area/precursor)
"aW" = (
/obj/structure/girder,
/turf/simulated/floor/plating,
/area/precursor)
"aX" = (
/obj/item/remains/human,
/obj/random/pack/cloth,
/obj/random/pack/cloth,
/obj/random/pack/gun_loot,
/turf/simulated/floor/beach/water/shallow,
/area/precursor)
"aY" = (
/obj/structure/disposalpipe/segment,
/obj/structure/catwalk,
/obj/random/junk,
/turf/simulated/floor/beach/water/shallow,
/area/precursor)
"aZ" = (
/obj/random/scrap/dense_even,
/turf/simulated/floor/beach/water/coastwater{
	dir = 4
	},
/area/precursor)
"ba" = (
/obj/machinery/light{
	dir = 4;
	icon_state = "tube1"
	},
/turf/simulated/floor/beach/water/ocean,
/area/precursor)
"bb" = (
/obj/item/remains/human,
/obj/random/pack/cloth,
/obj/random/pack/cloth,
/obj/random/pack/gun_loot,
/obj/random/pack/gun_loot,
/obj/machinery/light{
	dir = 8
	},
/turf/simulated/floor/beach/water/ocean,
/area/precursor)
"bc" = (
/obj/structure/disposalpipe/segment,
/obj/structure/catwalk,
/obj/random/scrap/dense_even,
/turf/simulated/floor/beach/water/shallow,
/area/precursor)
"bd" = (
/obj/random/junk,
/obj/random/junk,
/turf/simulated/floor/beach/water/shallow,
/area/precursor)
"be" = (
/obj/random/junk,
/turf/simulated/wall/r_wall,
/area/precursor)
"bf" = (
/obj/random/junk,
/turf/simulated/floor/plating,
/area/precursor)
"bg" = (
/obj/random/junk,
/obj/random/junk,
/turf/simulated/floor/holofloor/beach/sand,
/area/precursor)
"bh" = (
/obj/machinery/porta_turret,
/turf/simulated/floor/beach/water/shallow,
/area/precursor)
"bi" = (
/turf/simulated/floor/beach/water/coastwater{
	dir = 6
	},
/area/precursor)
"bj" = (
/obj/structure/disposalpipe/segment{
	icon_state = "pipe-s";
	dir = 4
	},
/obj/structure/catwalk,
/obj/machinery/light{
	dir = 1
	},
/turf/simulated/floor/beach/water/shallow,
/area/precursor)
"bk" = (
/obj/machinery/light{
	dir = 1
	},
/turf/simulated/floor/beach/water/shallow,
/area/precursor)
"bl" = (
/turf/simulated/floor/beach/water/shallow,
/area/precursor)
"bm" = (
/obj/structure/disposalpipe/segment,
/obj/structure/catwalk,
/turf/simulated/floor/beach/water/shallow,
/area/precursor)
"bn" = (
/obj/random/junk,
/obj/machinery/light{
	dir = 4;
	icon_state = "tube1"
	},
/turf/simulated/floor/beach/water/shallow,
/area/precursor)
"bo" = (
/obj/machinery/door/airlock/vault{
	icon_state = "door_locked";
	locked = 1;
	name = "AI Core"
	},
/turf/simulated/floor/tiled/steel/bar_dance,
/area/precursor)
"cY" = (
/obj/structure/table/reinforced,
/obj/random/pack/rare,
/obj/random/pack/rare,
/obj/random/pack/rare/low_chance,
/obj/random/pack/rare/low_chance,
/obj/random/dungeon_armor_mods,
/obj/random/dungeon_gun_energy,
/obj/random/dungeon_gun_energy,
/turf/simulated/floor/beach/water/ocean,
/area/precursor)
"id" = (
/obj/random/scrap/dense_even,
/turf/simulated/floor/holofloor/beach/sand,
/area/precursor)
"jp" = (
/obj/structure/catwalk,
/obj/structure/disposalpipe/segment{
	icon_state = "pipe-s";
	dir = 4
	},
/obj/random/cluster/psi_monster/low_chance,
/turf/simulated/floor/beach/water/shallow,
/area/precursor)
"ld" = (
/obj/structure/barricade,
/obj/structure/disposalpipe/segment,
/turf/simulated/floor/beach/water/shallow,
/area/precursor)
"lk" = (
/obj/random/junk,
/obj/random/mob/psi_monster/low_chance,
/turf/simulated/floor/plating/under,
/area/precursor)
"qh" = (
/obj/structure/disposalpipe/segment,
/obj/structure/catwalk,
/obj/random/cluster/psi_monster/low_chance,
/turf/simulated/floor/beach/water/shallow,
/area/precursor)
"rL" = (
/obj/random/mob/psi_monster/low_chance,
/turf/simulated/floor/beach/water/shallow,
/area/precursor)
"xe" = (
/turf/simulated/floor/beach/water/coastwater{
	dir = 8
	},
/area/precursor)
"Dx" = (
/obj/machinery/light{
	dir = 1
	},
/turf/simulated/floor/beach/water/coastwater{
	dir = 4
	},
/area/precursor)
"Ff" = (
/obj/structure/table/reinforced,
/obj/random/pack/rare,
/obj/random/pack/rare,
/obj/random/pack/rare/low_chance,
/obj/random/pack/rare/low_chance,
/obj/random/dungeon_gun_ballistic,
/obj/random/dungeon_gun_ballistic,
/turf/simulated/floor/beach/water/ocean,
/area/precursor)
"LI" = (
/obj/structure/table/reinforced,
/obj/random/pack/rare,
/obj/random/pack/rare,
/obj/random/pack/rare/low_chance,
/obj/random/pack/rare/low_chance,
/obj/random/dungeon_gun_ballistic,
/turf/simulated/floor/beach/water/ocean,
/area/precursor)
"Qc" = (
/obj/random/junk,
/obj/random/junk,
/obj/random/mob/psi_monster/low_chance,
/turf/simulated/floor/plating/under,
/area/precursor)
"QF" = (
/turf/simulated/floor/holofloor/beach/sand,
/area/precursor)
"Xy" = (
/turf/simulated/floor/beach/water/coastwater{
	dir = 10
	},
/area/precursor)

(1,1,1) = {"
bl
ad
bl
bl
bl
bl
bl
bl
bl
bl
bl
bl
bl
aT
bl
bl
rL
rL
bl
bn
aK
"}
(2,1,1) = {"
bl
au
au
au
au
au
au
au
aX
bl
rL
rL
bl
ab
ab
ab
ab
ab
au
au
bl
"}
(3,1,1) = {"
bl
aK
bl
bl
bl
aT
am
aq
at
at
at
at
at
aq
aA
rL
bl
aK
bl
rL
bl
"}
(4,1,1) = {"
bl
rL
bl
ae
ai
ld
an
ab
ab
ab
ab
ab
ab
ab
aB
bm
qh
aA
al
ab
bl
"}
(5,1,1) = {"
bl
au
aM
af
ab
ab
ab
ab
aS
aR
Qc
aS
aS
ab
au
au
ab
bj
al
au
aK
"}
(6,1,1) = {"
bl
au
aM
af
au
aQ
aR
lk
aQ
ab
ab
ab
aQ
aS
aS
aS
au
ag
al
au
bl
"}
(7,1,1) = {"
bl
au
aM
aP
au
aR
ab
ab
ab
ab
ac
au
au
au
au
aS
au
ag
al
ab
bl
"}
(8,1,1) = {"
bl
au
aM
af
au
aS
ab
aU
as
as
as
ar
as
as
au
aS
au
aJ
au
au
bk
"}
(9,1,1) = {"
bl
au
al
af
au
lk
ab
cY
as
ac
ba
ac
ac
as
au
aR
au
bh
bl
ab
bl
"}
(10,1,1) = {"
bl
bl
bl
ag
ab
aQ
au
aV
as
ab
ab
ac
aV
as
ab
aF
ab
xe
Xy
ab
rL
"}
(11,1,1) = {"
bl
aK
aK
jp
ab
aR
au
ac
ar
ab
ax
as
as
ar
aC
aG
aI
QF
aa
bo
bl
"}
(12,1,1) = {"
bl
bl
bl
af
ab
aS
au
ac
as
ab
ab
ac
as
az
ab
aH
ab
Dx
bi
ab
bl
"}
(13,1,1) = {"
bl
ab
al
af
au
aR
au
Ff
as
ac
bb
as
as
ac
ab
aR
ab
bh
bl
au
bl
"}
(14,1,1) = {"
bl
au
aM
af
au
aR
ab
LI
as
as
as
ar
ac
ac
ab
aR
au
aJ
ab
au
bk
"}
(15,1,1) = {"
bl
au
aM
aP
au
aR
ab
au
au
ab
ac
ab
au
au
ab
aS
au
ag
aN
ab
bl
"}
(16,1,1) = {"
bl
au
aM
af
au
aS
aR
aR
aR
ab
ab
be
aR
aR
aS
aS
au
ag
aN
ab
bl
"}
(17,1,1) = {"
bl
ab
aM
af
ab
ab
ab
aW
aO
bg
id
aO
aO
au
ab
ab
au
ay
aN
au
bl
"}
(18,1,1) = {"
bl
bl
bl
ah
ai
ak
ao
ab
aW
aZ
aZ
aW
ab
au
aD
bm
qh
aE
aN
au
bl
"}
(19,1,1) = {"
bl
bl
aK
bl
bl
aj
ap
aq
aY
aY
bc
bc
aw
aq
aE
bl
aK
bl
bl
bl
bl
"}
(20,1,1) = {"
bl
ab
au
au
au
ab
ab
ab
aK
rL
bd
bl
aK
au
au
aW
bf
aW
au
au
aK
"}
(21,1,1) = {"
bl
aL
bl
bl
bl
bl
aK
bl
bl
aK
bl
aK
bl
aK
aK
bl
aK
bl
aK
av
bl
"}
