//MAP CONVERTED BY dmm2tgm.py THIS HEADER COMMENT PREVENTS RECONVERSION, DO NOT REMOVE
"a" = (
/turf/template_noop,
/area/template_noop)
"g" = (
/obj/structure/flora/small/rock4,
/turf/simulated/floor/rock/seafloor,
/area/template_noop)
"h" = (
/turf/simulated/floor/rock/seafloor,
/area/template_noop)
"t" = (
/obj/structure/flora/small/rock2,
/turf/simulated/floor/rock/seafloor,
/area/template_noop)
"y" = (
/obj/random/closet_maintloot,
/turf/simulated/floor/rock/seafloor,
/area/template_noop)
"O" = (
/obj/structure/flora/small/rock5,
/turf/simulated/floor/rock/seafloor,
/area/template_noop)
"P" = (
/mob/living/carbon/superior_animal/human/voidwolf/ranged/aerotrooper,
/turf/simulated/floor/rock/seafloor,
/area/template_noop)
"Q" = (
/obj/structure/flora/rock/variant1,
/turf/simulated/floor/rock/seafloor,
/area/template_noop)

(1,1,1) = {"
a
a
a
a
a
"}
(2,1,1) = {"
a
Q
a
g
a
"}
(3,1,1) = {"
a
P
h
h
a
"}
(4,1,1) = {"
a
a
O
h
t
"}
(5,1,1) = {"
a
h
a
y
a
"}
