//MAP CONVERTED BY dmm2tgm.py THIS HEADER COMMENT PREVENTS RECONVERSION, DO NOT REMOVE
"a" = (
/turf/template_noop,
/area/template_noop)
"b" = (
/obj/structure/bed/chair/comfy/teal{
	dir = 4
	},
/obj/random/mob/space_legion,
/turf/simulated/floor,
/area/template_noop)
"c" = (
/turf/simulated/floor/plating/under,
/area/template_noop)
"e" = (
/obj/random/mob/space_legion,
/turf/simulated/floor/plating/under,
/area/template_noop)
"h" = (
/obj/random/gun_fancy/low_chance,
/turf/simulated/floor/plating/under,
/area/template_noop)
"k" = (
/obj/random/mob/voidwolf,
/turf/simulated/floor,
/area/template_noop)
"m" = (
/obj/structure/bed/chair/comfy/teal,
/obj/random/mob/space_legion,
/turf/simulated/floor,
/area/template_noop)
"n" = (
/obj/random/mob/space_legion,
/turf/simulated/floor,
/area/template_noop)
"o" = (
/obj/structure/girder/low,
/turf/simulated/floor/plating/under,
/area/template_noop)
"p" = (
/obj/structure/fuel_port,
/turf/simulated/wall/r_wall,
/area/template_noop)
"u" = (
/obj/item/material/shard,
/turf/simulated/floor,
/area/template_noop)
"x" = (
/obj/random/rig/low_chance,
/turf/simulated/floor,
/area/template_noop)
"y" = (
/turf/simulated/floor,
/area/template_noop)
"A" = (
/obj/random/lathe_disk/advanced/low_chance,
/turf/simulated/floor,
/area/template_noop)
"C" = (
/obj/random/gun_fancy/low_chance,
/turf/simulated/floor,
/area/template_noop)
"F" = (
/obj/structure/girder,
/turf/simulated/floor/plating/under,
/area/template_noop)
"G" = (
/turf/simulated/wall/r_wall,
/area/template_noop)
"H" = (
/obj/random/mob/space_legion,
/turf/template_noop,
/area/template_noop)
"I" = (
/obj/structure/bed/chair/comfy/teal{
	dir = 1
	},
/turf/simulated/floor/plating/under,
/area/template_noop)
"K" = (
/obj/random/mob/voidwolf,
/turf/template_noop,
/area/template_noop)
"L" = (
/obj/structure/low_wall,
/turf/simulated/floor/plating/under,
/area/template_noop)
"M" = (
/obj/random/mob/voidwolf,
/turf/simulated/floor/plating/under,
/area/template_noop)
"O" = (
/obj/random/soda/low_chance,
/turf/simulated/floor/plating/under,
/area/template_noop)
"Q" = (
/obj/random/rig_module/low_chance,
/turf/simulated/floor/plating/under,
/area/template_noop)
"R" = (
/obj/item/material/shard,
/turf/template_noop,
/area/template_noop)
"X" = (
/obj/random/soda/low_chance,
/turf/simulated/floor,
/area/template_noop)

(1,1,1) = {"
a
a
a
a
a
a
a
a
a
a
a
a
a
a
a
a
a
a
a
a
a
a
a
a
a
"}
(2,1,1) = {"
a
F
G
c
a
a
a
a
a
a
a
a
a
a
a
a
a
a
a
a
a
a
a
a
a
"}
(3,1,1) = {"
a
G
m
c
a
a
a
a
a
a
a
a
a
a
a
a
a
a
a
a
a
a
a
a
a
"}
(4,1,1) = {"
a
F
G
c
a
a
a
a
a
a
a
a
F
G
F
a
a
a
a
a
H
a
a
a
a
"}
(5,1,1) = {"
a
a
K
a
a
a
a
a
a
a
a
K
G
b
G
a
a
a
a
a
a
a
a
a
a
"}
(6,1,1) = {"
a
a
a
a
a
a
K
a
a
a
a
a
c
c
c
K
a
a
a
a
a
a
a
a
a
"}
(7,1,1) = {"
a
a
a
a
a
a
F
G
c
a
a
a
a
a
a
a
a
a
a
a
a
a
a
a
a
"}
(8,1,1) = {"
a
a
a
a
a
a
G
m
c
a
a
a
a
a
a
a
a
a
a
K
a
a
a
a
a
"}
(9,1,1) = {"
a
a
a
a
a
a
F
G
c
a
a
a
a
a
a
a
a
a
a
a
a
a
a
a
a
"}
(10,1,1) = {"
a
a
a
a
a
a
a
K
a
a
a
a
a
a
a
a
a
a
a
a
a
a
a
a
a
"}
(11,1,1) = {"
a
a
a
a
a
a
a
R
a
a
a
o
o
o
c
c
c
o
G
G
G
o
a
K
a
"}
(12,1,1) = {"
a
a
a
a
a
a
a
a
a
a
o
o
y
y
A
c
c
y
A
y
A
y
a
a
a
"}
(13,1,1) = {"
a
a
H
a
a
R
a
a
a
a
o
c
C
y
y
c
c
c
c
c
c
y
a
a
a
"}
(14,1,1) = {"
a
a
a
a
a
a
o
o
o
G
o
c
y
y
y
X
k
y
y
x
y
o
a
a
a
"}
(15,1,1) = {"
a
R
a
a
a
R
L
c
y
u
y
h
y
c
c
c
c
O
c
y
k
o
a
a
a
"}
(16,1,1) = {"
a
a
a
a
a
a
L
c
I
c
c
y
y
Q
c
M
c
c
c
y
y
c
a
a
a
"}
(17,1,1) = {"
a
R
a
a
R
a
L
k
y
y
y
y
y
c
c
c
c
O
c
X
y
G
a
a
a
"}
(18,1,1) = {"
a
a
a
a
a
a
o
G
o
o
o
y
k
y
y
y
y
y
y
y
n
G
a
H
a
"}
(19,1,1) = {"
a
a
a
a
a
a
R
a
a
a
o
y
y
y
c
h
c
Q
c
c
c
G
a
a
a
"}
(20,1,1) = {"
a
a
a
R
a
a
a
a
a
a
o
o
y
C
c
c
c
e
c
c
c
G
a
a
a
"}
(21,1,1) = {"
a
a
a
a
a
H
a
a
a
a
a
o
y
o
G
y
o
o
o
o
o
p
a
a
a
"}
(22,1,1) = {"
a
a
a
a
a
a
a
a
a
a
a
a
a
a
a
a
a
a
a
a
a
a
a
a
a
"}
(23,1,1) = {"
a
a
a
a
a
a
a
a
a
a
a
a
a
a
a
a
a
a
a
a
a
a
a
a
a
"}
(24,1,1) = {"
a
a
a
a
a
a
a
a
a
a
a
a
a
a
a
a
a
a
a
a
a
a
a
a
a
"}
(25,1,1) = {"
a
a
a
a
a
a
a
a
a
a
a
a
a
a
a
a
a
a
a
a
a
a
a
a
a
"}
