//MAP CONVERTED BY dmm2tgm.py THIS HEADER COMMENT PREVENTS RECONVERSION, DO NOT REMOVE
"a" = (
/turf/simulated/floor/asteroid/grass,
/area/precursor)
"b" = (
/turf/simulated/wall,
/area/precursor)
"c" = (
/turf/simulated/floor/tiled/dark/panels,
/area/precursor)
"d" = (
/obj/machinery/artifact_analyser,
/turf/simulated/floor/tiled/dark/cargo,
/area/precursor)
"e" = (
/obj/machinery/artifact_scanpad,
/obj/machinery/artifact,
/turf/simulated/floor/tiled/dark/danger,
/area/precursor)
"f" = (
/turf/simulated/wall/rust_standard,
/area/precursor)
"g" = (
/turf/simulated/floor/tiled/dark/danger,
/area/precursor)
"h" = (
/turf/simulated/floor/tiled/dark/techfloor_grid,
/area/precursor)
"i" = (
/obj/machinery/power/emitter/anchored{
	tag = "icon-emitter (NORTH)";
	icon_state = "emitter";
	dir = 1
	},
/turf/simulated/floor/tiled/dark/danger,
/area/precursor)
"j" = (
/obj/random/cluster/psi_monster/low_chance,
/turf/simulated/floor/tiled/dark/techfloor_grid,
/area/precursor)
"k" = (
/turf/simulated/floor/tiled/dark/gray_platform,
/area/precursor)
"l" = (
/obj/random/pack/machine,
/turf/simulated/floor/tiled/dark/gray_perforated,
/area/precursor)
"m" = (
/obj/structure/table/standard,
/obj/random/pack/tech_loot,
/obj/random/pack/tech_loot,
/obj/random/pack/tech_loot,
/obj/random/pack/tech_loot/low_chance,
/turf/simulated/floor/tiled/dark/gray_perforated,
/area/precursor)
"n" = (
/obj/item/stool,
/turf/simulated/floor/tiled/dark/gray_perforated,
/area/precursor)
"o" = (
/obj/structure/table/standard,
/obj/random/pack/rare,
/turf/simulated/floor/tiled/dark/gray_perforated,
/area/precursor)
"q" = (
/obj/structure/table/standard,
/obj/random/pack/rare/low_chance,
/obj/random/pack/rare/low_chance,
/turf/simulated/floor/tiled/dark/gray_perforated,
/area/precursor)
"s" = (
/obj/machinery/light/small{
	dir = 4;
	pixel_y = 0
	},
/turf/simulated/floor/tiled/dark/cargo,
/area/precursor)
"t" = (
/obj/machinery/light/small{
	dir = 1
	},
/turf/simulated/floor/tiled/dark/techfloor_grid,
/area/precursor)
"z" = (
/obj/structure/table/standard,
/obj/random/pack/rare,
/obj/random/material/low_chance,
/turf/simulated/floor/tiled/dark/gray_perforated,
/area/precursor)
"L" = (
/turf/unsimulated/wall/jungle,
/area/precursor)
"O" = (
/obj/random/mob/psi_monster/low_chance,
/turf/simulated/floor/asteroid/grass,
/area/precursor)
"P" = (
/obj/item/stool,
/obj/random/mob/psi_monster/low_chance,
/turf/simulated/floor/tiled/dark/gray_perforated,
/area/precursor)
"S" = (
/obj/random/mob/psi_monster/low_chance,
/turf/simulated/floor/tiled/dark/danger,
/area/precursor)

(1,1,1) = {"
O
a
a
a
a
a
a
a
a
a
O
"}
(2,1,1) = {"
a
L
L
L
L
L
c
l
n
a
a
"}
(3,1,1) = {"
a
L
L
L
L
c
c
m
P
n
a
"}
(4,1,1) = {"
a
L
L
S
g
g
i
m
o
q
a
"}
(5,1,1) = {"
a
L
b
b
f
t
h
h
k
k
a
"}
(6,1,1) = {"
a
c
c
c
c
h
j
h
k
k
a
"}
(7,1,1) = {"
a
f
f
f
f
h
h
h
k
L
a
"}
(8,1,1) = {"
a
b
e
S
g
g
i
m
z
L
a
"}
(9,1,1) = {"
a
b
d
s
b
c
c
m
P
L
a
"}
(10,1,1) = {"
a
f
f
b
b
c
c
l
L
L
a
"}
(11,1,1) = {"
O
a
a
a
a
a
a
a
a
a
O
"}
