//MAP CONVERTED BY dmm2tgm.py THIS HEADER COMMENT PREVENTS RECONVERSION, DO NOT REMOVE
"a" = (
/turf/simulated/floor/tiled/steel/monofloor,
/area/precursor)
"b" = (
/obj/random/mob/psi_monster/low_chance,
/turf/simulated/floor/tiled/techmaint_panels,
/area/precursor)
"c" = (
/turf/simulated/wall,
/area/precursor)
"d" = (
/obj/random/junk,
/turf/simulated/floor/tiled/techmaint_cargo,
/area/precursor)
"e" = (
/obj/random/pack/machine,
/turf/simulated/floor/tiled/techmaint_perforated,
/area/precursor)
"f" = (
/turf/simulated/floor/tiled/techmaint,
/area/precursor)
"g" = (
/obj/structure/table/rack/shelf,
/obj/random/pack/tech_loot,
/obj/random/pack/tech_loot,
/obj/random/pack/tech_loot/low_chance,
/obj/random/pack/tech_loot/low_chance,
/obj/random/ammo,
/obj/random/ammo_fancy,
/obj/random/ammo_lowcost,
/turf/simulated/floor/tiled/techmaint_perforated,
/area/precursor)
"h" = (
/obj/random/junk,
/turf/simulated/floor/tiled/techmaint,
/area/precursor)
"i" = (
/turf/simulated/floor/beach/water/coastwatercorner{
	dir = 1
	},
/area/precursor)
"j" = (
/obj/random/cluster/psi_monster/low_chance,
/turf/simulated/floor/tiled/techmaint,
/area/precursor)
"k" = (
/turf/simulated/floor/beach/water/coastwater{
	dir = 4
	},
/area/precursor)
"l" = (
/obj/effect/gibspawner/human,
/turf/simulated/floor/beach/water/shallow,
/area/precursor)
"m" = (
/obj/structure/table/rack/shelf,
/obj/random/pack/cloth,
/obj/random/pack/cloth,
/obj/random/pack/cloth/low_chance,
/turf/simulated/floor/tiled/techmaint_perforated,
/area/precursor)
"n" = (
/turf/simulated/floor/tiled/techmaint_cargo,
/area/precursor)
"o" = (
/obj/structure/table/rack/shelf,
/obj/random/pack/tech_loot,
/obj/random/pack/tech_loot,
/obj/random/pack/tech_loot/low_chance,
/obj/random/pack/tech_loot/low_chance,
/obj/machinery/light/small{
	dir = 1
	},
/obj/random/ammo,
/obj/random/ammo_fancy,
/obj/random/ammo_lowcost,
/turf/simulated/floor/tiled/techmaint_perforated,
/area/precursor)
"p" = (
/obj/structure/table/rack/shelf,
/obj/random/pack/cloth,
/obj/random/pack/cloth,
/obj/random/pack/cloth/low_chance,
/obj/machinery/light/small,
/turf/simulated/floor/tiled/techmaint_perforated,
/area/precursor)
"s" = (
/turf/simulated/floor/beach/water/coastwater{
	dir = 8
	},
/area/precursor)
"t" = (
/turf/simulated/floor/beach/water/coastwatercorner{
	dir = 4
	},
/area/precursor)
"x" = (
/turf/simulated/floor/beach/sand/desert,
/area/precursor)
"y" = (
/turf/simulated/floor/tiled/techmaint_panels,
/area/precursor)
"z" = (
/obj/random/junk,
/turf/simulated/floor/beach/sand/desert,
/area/precursor)
"B" = (
/obj/random/mob/psi_monster/low_chance,
/turf/simulated/floor/tiled/steel/monofloor,
/area/precursor)
"C" = (
/turf/simulated/floor/beach/water/coastwatercorner{
	dir = 3
	},
/area/precursor)
"F" = (
/obj/effect/gibspawner/human,
/turf/simulated/floor/beach/sand/desert,
/area/precursor)
"I" = (
/turf/simulated/wall/rust_standard,
/area/precursor)
"L" = (
/obj/random/pack/machine,
/turf/simulated/floor/beach/sand/desert,
/area/precursor)
"O" = (
/obj/random/mob/psi_monster/low_chance,
/turf/simulated/floor/beach/sand/desert,
/area/precursor)
"Q" = (
/turf/simulated/floor/beach/water/coastwater{
	dir = 1
	},
/area/precursor)
"S" = (
/turf/simulated/floor/beach/water/coastwater,
/area/precursor)
"T" = (
/obj/random/mob/psi_monster/low_chance,
/turf/simulated/floor/tiled/techmaint,
/area/precursor)
"V" = (
/obj/random/cluster/psi_monster/lower_chance,
/turf/simulated/floor/tiled/techmaint,
/area/precursor)
"Z" = (
/turf/simulated/floor/beach/water/coastwatercorner{
	dir = 8
	},
/area/precursor)

(1,1,1) = {"
x
x
x
O
x
a
a
a
a
B
a
"}
(2,1,1) = {"
x
F
x
x
x
I
I
I
c
c
y
"}
(3,1,1) = {"
x
x
L
L
e
e
e
e
e
I
y
"}
(4,1,1) = {"
O
z
x
x
x
j
f
h
f
n
b
"}
(5,1,1) = {"
x
I
g
z
C
k
Z
f
m
c
y
"}
(6,1,1) = {"
x
I
o
f
S
l
Q
V
p
I
y
"}
(7,1,1) = {"
x
I
g
T
i
s
t
f
m
I
y
"}
(8,1,1) = {"
O
d
f
f
f
j
f
h
f
d
b
"}
(9,1,1) = {"
x
I
e
e
e
e
e
e
e
c
x
"}
(10,1,1) = {"
x
I
I
I
I
I
c
c
c
c
F
"}
(11,1,1) = {"
F
a
a
a
B
a
a
a
B
a
a
"}
