//MAP CONVERTED BY dmm2tgm.py THIS HEADER COMMENT PREVENTS RECONVERSION, DO NOT REMOVE
"a" = (
/obj/structure/catwalk,
/turf/simulated/floor/plating/under,
/area/precursor)
"b" = (
/obj/structure/catwalk,
/obj/machinery/atmospherics/pipe/simple/visible/yellow{
	dir = 4
	},
/turf/simulated/floor/plating/under,
/area/precursor)
"c" = (
/obj/structure/railing{
	tag = "icon-railing0 (NORTH)";
	icon_state = "railing0";
	dir = 1
	},
/obj/structure/railing{
	tag = "icon-railing0 (WEST)";
	icon_state = "railing0";
	dir = 8
	},
/obj/machinery/atmospherics/pipe/simple/visible/yellow{
	dir = 4
	},
/turf/simulated/floor/plating/under,
/area/precursor)
"d" = (
/obj/structure/railing{
	tag = "icon-railing0 (NORTH)";
	icon_state = "railing0";
	dir = 1
	},
/obj/random/junk/low_chance,
/obj/machinery/atmospherics/pipe/simple/visible/yellow{
	dir = 4
	},
/turf/simulated/floor/plating/under,
/area/precursor)
"e" = (
/obj/structure/railing{
	tag = "icon-railing0 (NORTH)";
	icon_state = "railing0";
	dir = 1
	},
/obj/machinery/atmospherics/pipe/simple/visible/yellow{
	dir = 4
	},
/turf/simulated/floor/plating/under,
/area/precursor)
"f" = (
/obj/structure/railing{
	tag = "icon-railing0 (EAST)";
	icon_state = "railing0";
	dir = 4
	},
/obj/structure/railing{
	tag = "icon-railing0 (NORTH)";
	icon_state = "railing0";
	dir = 1
	},
/obj/machinery/atmospherics/pipe/simple/visible/yellow{
	dir = 4
	},
/turf/simulated/floor/plating/under,
/area/precursor)
"g" = (
/obj/structure/railing{
	tag = "icon-railing0 (WEST)";
	icon_state = "railing0";
	dir = 8
	},
/obj/structure/railing,
/turf/simulated/floor/plating/under,
/area/precursor)
"h" = (
/obj/structure/railing,
/turf/simulated/floor/plating/under,
/area/precursor)
"i" = (
/obj/structure/railing,
/obj/random/junk/low_chance,
/turf/simulated/floor/plating/under,
/area/precursor)
"j" = (
/obj/structure/railing{
	tag = "icon-railing0 (EAST)";
	icon_state = "railing0";
	dir = 4
	},
/obj/structure/railing,
/turf/simulated/floor/plating/under,
/area/precursor)
"k" = (
/obj/structure/catwalk,
/obj/random/cluster/psi_monster/low_chance,
/turf/simulated/floor/plating/under,
/area/precursor)
"l" = (
/obj/structure/railing{
	tag = "icon-railing0 (NORTH)";
	icon_state = "railing0";
	dir = 1
	},
/obj/structure/railing{
	tag = "icon-railing0 (WEST)";
	icon_state = "railing0";
	dir = 8
	},
/turf/simulated/floor/plating/under,
/area/precursor)
"m" = (
/obj/structure/railing{
	tag = "icon-railing0 (NORTH)";
	icon_state = "railing0";
	dir = 1
	},
/obj/structure/railing{
	tag = "icon-railing0 (EAST)";
	icon_state = "railing0";
	dir = 4
	},
/turf/simulated/floor/plating/under,
/area/precursor)
"n" = (
/obj/structure/table/standard,
/obj/random/pack/tech_loot,
/obj/random/pack/tech_loot,
/obj/random/pack/tech_loot,
/obj/random/pack/tech_loot/low_chance,
/obj/random/pack/tech_loot/low_chance,
/obj/random/dungeon_ammo/low_chance,
/turf/simulated/floor/holofloor/snow,
/area/precursor)
"o" = (
/obj/structure/table/standard,
/obj/random/dungeon_gun_mods/low_chance,
/turf/simulated/floor/tiled/techmaint_perforated,
/area/precursor)
"p" = (
/obj/structure/railing{
	tag = "icon-railing0 (EAST)";
	icon_state = "railing0";
	dir = 4
	},
/obj/structure/railing{
	tag = "icon-railing0 (NORTH)";
	icon_state = "railing0";
	dir = 1
	},
/turf/simulated/floor/plating/under,
/area/precursor)
"q" = (
/obj/structure/railing{
	tag = "icon-railing0 (WEST)";
	icon_state = "railing0";
	dir = 8
	},
/obj/random/junk/low_chance,
/turf/simulated/floor/holofloor/snow,
/area/precursor)
"r" = (
/obj/random/junk/low_chance,
/obj/effect/floor_decal/spline/snow_edge{
	dir = 8;
	layer = 3
	},
/obj/effect/floor_decal/spline/snow_edge{
	dir = 4
	},
/obj/effect/floor_decal/spline/snow_edge{
	dir = 3
	},
/turf/simulated/floor/plating/under,
/area/precursor)
"s" = (
/obj/structure/flora/small/snow/rock8,
/turf/simulated/floor/holofloor/snow,
/area/precursor)
"t" = (
/obj/structure/bed/chair{
	dir = 1
	},
/turf/simulated/floor/tiled/techmaint_perforated,
/area/precursor)
"u" = (
/obj/structure/railing{
	tag = "icon-railing0 (WEST)";
	icon_state = "railing0";
	dir = 8
	},
/obj/random/junk/low_chance,
/obj/structure/railing,
/turf/simulated/floor/plating/under,
/area/precursor)
"v" = (
/obj/structure/railing{
	tag = "icon-railing0 (EAST)";
	icon_state = "railing0";
	dir = 4
	},
/obj/random/junk/low_chance,
/turf/simulated/floor/plating/under,
/area/precursor)
"w" = (
/obj/random/pack/machine,
/turf/simulated/floor/holofloor/snow,
/area/precursor)
"x" = (
/obj/random/pack/machine,
/turf/simulated/floor/tiled/techmaint_cargo,
/area/precursor)
"y" = (
/turf/simulated/floor/tiled/techmaint_cargo,
/area/precursor)
"z" = (
/turf/simulated/floor/tiled/techmaint_perforated,
/area/precursor)
"A" = (
/obj/structure/railing{
	tag = "icon-railing0 (EAST)";
	icon_state = "railing0";
	dir = 4
	},
/obj/structure/railing,
/obj/structure/railing{
	tag = "icon-railing0 (WEST)";
	icon_state = "railing0";
	dir = 8
	},
/turf/simulated/floor/plating/under,
/area/precursor)
"B" = (
/turf/simulated/floor/holofloor/snow,
/area/precursor)
"C" = (
/obj/structure/railing{
	tag = "icon-railing0 (NORTH)";
	icon_state = "railing0";
	dir = 1
	},
/turf/simulated/floor/plating/under,
/area/precursor)
"D" = (
/obj/structure/railing{
	tag = "icon-railing0 (NORTH)";
	icon_state = "railing0";
	dir = 1
	},
/obj/random/junk/low_chance,
/turf/simulated/floor/plating/under,
/area/precursor)
"E" = (
/obj/structure/railing,
/obj/structure/flora/tree/snow/two,
/turf/simulated/floor/holofloor/snow,
/area/precursor)
"F" = (
/obj/structure/railing,
/obj/random/junk/low_chance,
/obj/machinery/atmospherics/pipe/simple/visible/yellow{
	dir = 4
	},
/turf/simulated/floor/plating/under,
/area/precursor)
"G" = (
/obj/structure/railing,
/obj/machinery/atmospherics/pipe/simple/visible/yellow{
	dir = 4
	},
/turf/simulated/floor/plating/under,
/area/precursor)
"H" = (
/obj/machinery/atmospherics/pipe/simple/visible/yellow{
	dir = 4
	},
/obj/structure/railing,
/turf/simulated/floor/plating/under,
/area/precursor)
"I" = (
/obj/structure/railing,
/obj/structure/railing{
	tag = "icon-railing0 (EAST)";
	icon_state = "railing0";
	dir = 4
	},
/obj/machinery/atmospherics/pipe/simple/visible/yellow{
	dir = 4
	},
/turf/simulated/floor/plating/under,
/area/precursor)
"M" = (
/obj/structure/flora/small/snow/boulder1,
/turf/simulated/floor/holofloor/snow,
/area/precursor)
"N" = (
/obj/random/mob/psi_monster/low_chance,
/turf/simulated/floor/holofloor/snow,
/area/precursor)
"O" = (
/obj/random/junk/low_chance,
/turf/simulated/floor/holofloor/snow,
/area/precursor)
"P" = (
/obj/structure/table/standard,
/obj/random/pack/tech_loot,
/obj/random/pack/tech_loot,
/obj/random/pack/tech_loot,
/obj/random/pack/tech_loot/low_chance,
/obj/random/pack/tech_loot/low_chance,
/obj/random/dungeon_gun_ballistic/low_chance,
/turf/simulated/floor/tiled/techmaint_perforated,
/area/precursor)
"Q" = (
/obj/structure/catwalk,
/obj/random/mob/psi_monster/low_chance,
/turf/simulated/floor/plating/under,
/area/precursor)
"U" = (
/obj/structure/flora/tree/snow/two,
/turf/simulated/floor/holofloor/snow,
/area/precursor)
"V" = (
/obj/structure/flora/small/snow/rock5,
/turf/simulated/floor/holofloor/snow,
/area/precursor)
"W" = (
/obj/random/cluster/psi_monster/low_chance,
/turf/simulated/floor/holofloor/snow,
/area/precursor)
"X" = (
/obj/structure/railing{
	tag = "icon-railing0 (NORTH)";
	icon_state = "railing0";
	dir = 1
	},
/obj/structure/railing{
	tag = "icon-railing0 (WEST)";
	icon_state = "railing0";
	dir = 8
	},
/obj/structure/flora/small/snow/boulder2,
/turf/simulated/floor/holofloor/snow,
/area/precursor)
"Y" = (
/obj/random/mob/psi_monster/low_chance,
/turf/simulated/floor/tiled/techmaint_perforated,
/area/precursor)
"Z" = (
/obj/structure/table/standard,
/obj/random/pack/rare/low_chance,
/obj/random/pack/rare/low_chance,
/obj/random/dungeon_gun_energy/low_chance,
/turf/simulated/floor/tiled/techmaint_perforated,
/area/precursor)

(1,1,1) = {"
a
b
a
a
a
a
a
B
V
B
B
"}
(2,1,1) = {"
Q
c
g
a
X
q
q
B
B
E
a
"}
(3,1,1) = {"
B
d
h
B
U
r
w
B
B
F
Q
"}
(4,1,1) = {"
B
e
O
W
B
B
B
N
D
G
a
"}
(5,1,1) = {"
B
B
B
B
n
s
z
a
C
H
a
"}
(6,1,1) = {"
B
B
O
B
o
t
Y
a
C
F
a
"}
(7,1,1) = {"
M
B
h
a
P
Z
z
a
C
G
a
"}
(8,1,1) = {"
B
B
i
k
a
a
y
Q
C
F
a
"}
(9,1,1) = {"
U
d
h
a
l
u
x
a
D
G
Q
"}
(10,1,1) = {"
Q
f
j
a
p
v
A
a
m
I
a
"}
(11,1,1) = {"
a
b
a
a
a
a
a
a
a
b
a
"}
