//MAP CONVERTED BY dmm2tgm.py THIS HEADER COMMENT PREVENTS RECONVERSION, DO NOT REMOVE
"a" = (
/turf/simulated/floor/tiled/steel/brown_platform,
/area/precursor)
"b" = (
/turf/simulated/wall,
/area/precursor)
"c" = (
/obj/effect/window_lwall_spawn/smartspawn,
/obj/structure/low_wall/rusted,
/turf/simulated/floor/plating,
/area/precursor)
"e" = (
/turf/simulated/floor/snow,
/area/precursor)
"f" = (
/obj/structure/flora/small/snow/boulder1,
/turf/simulated/floor/snow,
/area/precursor)
"g" = (
/obj/random/pack/junk_machine,
/turf/simulated/floor/snow,
/area/precursor)
"h" = (
/obj/machinery/portable_atmospherics/hydroponics,
/turf/simulated/floor/asteroid/grass,
/area/precursor)
"i" = (
/obj/structure/table/woodentable,
/obj/random/pack/rare,
/obj/random/pack/gun_loot/low_chance,
/obj/random/pack/gun_loot/low_chance,
/obj/random/pack/gun_loot/low_chance,
/obj/random/gun_shotgun/low_chance,
/turf/simulated/floor/snow,
/area/precursor)
"j" = (
/obj/structure/table/woodentable,
/obj/random/pack/rare/low_chance,
/obj/random/pack/rare/low_chance,
/obj/random/firstaid/low_chance,
/turf/simulated/floor/snow,
/area/precursor)
"k" = (
/turf/simulated/floor/asteroid/dirt,
/area/precursor)
"l" = (
/obj/random/mob/psi_monster/low_chance,
/turf/simulated/floor/snow,
/area/precursor)
"m" = (
/obj/structure/flora/small/snow/rock2,
/turf/simulated/floor/snow,
/area/precursor)
"n" = (
/turf/simulated/floor/tiled/steel/cargo,
/area/precursor)
"o" = (
/obj/machinery/door/airlock/glass{
	name = "Hydroponics";
	req_access = list(35)
	},
/turf/simulated/floor/wood,
/area/precursor)
"p" = (
/turf/simulated/floor/tiled/steel/panels,
/area/precursor)
"q" = (
/obj/random/traps/low_chance,
/turf/simulated/floor/tiled/steel/panels,
/area/precursor)
"r" = (
/obj/structure/table/woodentable,
/obj/random/pack/tech_loot,
/obj/random/pack/tech_loot,
/obj/random/pack/tech_loot/low_chance,
/obj/random/pack/tech_loot/low_chance,
/obj/random/tool_upgrade/rare/low_chance,
/turf/simulated/floor/asteroid/grass,
/area/precursor)
"t" = (
/obj/machinery/light/small,
/turf/simulated/floor/snow,
/area/precursor)
"u" = (
/obj/machinery/light/small{
	dir = 1
	},
/turf/simulated/floor/wood,
/area/precursor)
"v" = (
/obj/structure/flora/small/snow/rock3,
/turf/simulated/floor/snow,
/area/precursor)
"y" = (
/obj/structure/flora/small/snow/rock8,
/turf/simulated/floor/snow,
/area/precursor)
"z" = (
/obj/random/pack/deep_machine/low_chance,
/turf/simulated/floor/snow,
/area/precursor)
"A" = (
/obj/random/pack/deep_machine,
/turf/simulated/floor/snow,
/area/precursor)
"B" = (
/obj/structure/flora/small/snow/rock5,
/turf/simulated/floor/snow,
/area/precursor)
"E" = (
/obj/random/traps/low_chance,
/turf/simulated/floor/snow,
/area/precursor)
"F" = (
/obj/random/mob/psi_monster/low_chance,
/turf/simulated/floor/wood,
/area/precursor)
"G" = (
/obj/random/cluster/psi_monster/low_chance,
/turf/simulated/floor/snow,
/area/precursor)
"I" = (
/obj/random/mob/psi_monster/low_chance,
/turf/simulated/floor/tiled/steel/brown_platform,
/area/precursor)
"N" = (
/obj/random/cluster/psi_monster/low_chance,
/turf/simulated/floor/tiled/steel/brown_platform,
/area/precursor)
"P" = (
/obj/effect/window_lwall_spawn/smartspawn,
/obj/structure/low_wall/rusted,
/obj/structure/low_wall/rusted,
/turf/simulated/floor/plating,
/area/precursor)
"Q" = (
/obj/random/mob/psi_monster/low_chance,
/turf/simulated/floor/tiled/steel/cargo,
/area/precursor)
"S" = (
/obj/random/mob/psi_monster/low_chance,
/turf/simulated/floor/asteroid/dirt,
/area/precursor)
"T" = (
/obj/structure/low_wall/rusted,
/turf/simulated/floor/snow,
/area/precursor)
"W" = (
/obj/structure/flora/small/snow/rock6,
/obj/structure/low_wall/rusted,
/turf/simulated/floor/snow,
/area/precursor)
"Y" = (
/obj/effect/window_lwall_spawn/smartspawn,
/obj/structure/low_wall/rusted,
/turf/simulated/floor/snow,
/area/precursor)
"Z" = (
/turf/simulated/wall/rust_standard,
/area/precursor)

(1,1,1) = {"
y
e
e
G
e
e
e
v
e
a
I
"}
(2,1,1) = {"
e
Z
W
T
Z
f
Z
c
c
Z
a
"}
(3,1,1) = {"
e
T
e
l
Y
E
c
r
r
c
a
"}
(4,1,1) = {"
e
e
e
e
P
p
c
S
r
c
a
"}
(5,1,1) = {"
l
m
g
t
b
q
Z
u
h
c
I
"}
(6,1,1) = {"
e
Y
A
m
o
p
o
F
h
c
a
"}
(7,1,1) = {"
e
c
z
t
b
q
Z
u
h
c
a
"}
(8,1,1) = {"
e
c
i
l
c
p
c
k
r
c
a
"}
(9,1,1) = {"
e
c
j
e
c
p
c
r
r
c
a
"}
(10,1,1) = {"
B
Z
c
c
b
q
b
c
c
b
I
"}
(11,1,1) = {"
e
I
a
a
Q
n
n
N
a
a
a
"}
