//MAP CONVERTED BY dmm2tgm.py THIS HEADER COMMENT PREVENTS RECONVERSION, DO NOT REMOVE
"a" = (
/turf/simulated/floor/tiled/steel/brown_perforated,
/area/precursor)
"b" = (
/obj/machinery/light/small,
/turf/simulated/floor/tiled/steel/brown_perforated,
/area/precursor)
"c" = (
/turf/simulated/wall,
/area/precursor)
"d" = (
/turf/simulated/floor/tiled/steel/cargo,
/area/precursor)
"e" = (
/obj/machinery/mech_recharger,
/obj/random/mecha/low_chance,
/turf/simulated/floor/tiled/steel,
/area/precursor)
"f" = (
/obj/machinery/light/small{
	dir = 1
	},
/turf/simulated/floor/tiled/steel/cargo,
/area/precursor)
"g" = (
/obj/random/traps/low_chance,
/turf/simulated/floor/tiled/steel/cargo,
/area/precursor)
"h" = (
/turf/simulated/floor/tiled/steel/gray_platform,
/area/precursor)
"i" = (
/obj/random/pack/machine,
/turf/simulated/floor/tiled/steel/gray_platform,
/area/precursor)
"j" = (
/obj/structure/table/standard{
	name = "plastic table frame"
	},
/obj/random/powercell,
/obj/random/powercell,
/obj/random/powercell,
/turf/simulated/floor/tiled/steel/gray_platform,
/area/precursor)
"k" = (
/obj/structure/reagent_dispensers/fueltank,
/turf/simulated/floor/tiled/steel/gray_platform,
/area/precursor)
"l" = (
/obj/structure/table/standard{
	name = "plastic table frame"
	},
/obj/random/pack/rare/low_chance,
/obj/random/psi_megafauna,
/obj/random/dungeon_gun_energy/low_chance,
/obj/random/dungeon_gun_energy/low_chance,
/turf/simulated/floor/tiled/steel/gray_platform,
/area/precursor)
"m" = (
/obj/random/cluster/psi_monster/low_chance,
/turf/simulated/floor/tiled/steel/gray_platform,
/area/precursor)
"n" = (
/obj/machinery/recharge_station,
/turf/simulated/floor/tiled/steel/gray_platform,
/area/precursor)
"o" = (
/obj/structure/table/standard{
	name = "plastic table frame"
	},
/obj/item/storage/toolbox/mechanical,
/turf/simulated/floor/tiled/steel/gray_platform,
/area/precursor)
"p" = (
/obj/structure/reagent_dispensers/fueltank,
/obj/machinery/light/small{
	dir = 1
	},
/turf/simulated/floor/tiled/steel/gray_platform,
/area/precursor)
"q" = (
/obj/structure/table/standard{
	name = "plastic table frame"
	},
/obj/random/pack/tech_loot,
/obj/random/pack/tech_loot,
/obj/random/pack/tech_loot/low_chance,
/obj/random/pack/tech_loot/low_chance,
/turf/simulated/floor/tiled/steel/gray_platform,
/area/precursor)
"r" = (
/obj/machinery/mech_recharger,
/obj/random/mecha/damaged,
/turf/simulated/floor/tiled/steel,
/area/precursor)
"s" = (
/obj/machinery/light/small{
	dir = 1
	},
/turf/simulated/floor/tiled/steel/brown_perforated,
/area/precursor)
"t" = (
/obj/random/junk,
/turf/simulated/floor/tiled/steel/brown_perforated,
/area/precursor)
"u" = (
/obj/machinery/door/airlock/maintenance_common{
	name = "Service Maintenance";
	req_access = list(12)
	},
/turf/simulated/floor/tiled/steel/cargo,
/area/precursor)
"v" = (
/obj/random/junk,
/turf/simulated/floor/tiled/steel/cargo,
/area/precursor)
"w" = (
/obj/random/junk,
/turf/simulated/floor/tiled/steel/gray_platform,
/area/precursor)
"x" = (
/obj/random/junk,
/obj/random/junk,
/turf/simulated/floor/tiled/steel/brown_perforated,
/area/precursor)
"K" = (
/obj/machinery/light/small{
	dir = 1
	},
/obj/random/mob/psi_monster/low_chance,
/turf/simulated/floor/tiled/steel/cargo,
/area/precursor)
"M" = (
/obj/random/mob/psi_monster/low_chance,
/turf/simulated/floor/tiled/steel/brown_perforated,
/area/precursor)
"O" = (
/obj/random/mob/psi_monster/low_chance,
/turf/simulated/floor/tiled/steel/cargo,
/area/precursor)
"W" = (
/obj/random/mob/psi_monster/low_chance,
/turf/simulated/floor/tiled/steel/gray_platform,
/area/precursor)

(1,1,1) = {"
t
a
a
a
t
a
a
a
a
x
t
"}
(2,1,1) = {"
a
c
c
f
w
W
h
d
c
c
t
"}
(3,1,1) = {"
a
c
e
O
h
m
h
v
e
c
t
"}
(4,1,1) = {"
a
c
e
d
i
n
i
d
e
c
t
"}
(5,1,1) = {"
b
c
c
g
j
c
o
g
c
c
s
"}
(6,1,1) = {"
M
u
v
O
k
c
p
O
d
u
M
"}
(7,1,1) = {"
b
c
c
g
l
c
q
g
c
c
s
"}
(8,1,1) = {"
a
c
e
d
i
n
i
d
e
c
a
"}
(9,1,1) = {"
t
c
e
d
h
m
h
d
r
c
t
"}
(10,1,1) = {"
a
c
c
K
h
W
h
d
c
c
x
"}
(11,1,1) = {"
t
a
a
a
a
a
a
t
t
a
t
"}
