//MAP CONVERTED BY dmm2tgm.py THIS HEADER COMMENT PREVENTS RECONVERSION, DO NOT REMOVE
"a" = (
/turf/simulated/floor/tiled/white/brown_platform,
/area/precursor)
"b" = (
/obj/structure/table/standard,
/obj/random/medical,
/obj/random/medical,
/obj/random/medical,
/obj/random/medical/low_chance,
/obj/random/medical/low_chance,
/obj/random/medical/low_chance,
/turf/simulated/floor/tiled/white/brown_perforated,
/area/precursor)
"c" = (
/obj/structure/closet/crate/freezer,
/obj/random/pack/rare/low_chance,
/turf/simulated/floor/tiled/white/brown_perforated,
/area/precursor)
"d" = (
/obj/structure/table/standard,
/obj/random/surgery_tool,
/obj/random/surgery_tool/low_chance,
/turf/simulated/floor/tiled/white/brown_perforated,
/area/precursor)
"e" = (
/obj/structure/table/standard,
/obj/random/lowkeyrandom,
/obj/random/lowkeyrandom,
/turf/simulated/floor/tiled/white/brown_perforated,
/area/precursor)
"f" = (
/obj/random/medical_lowcost,
/turf/simulated/floor/beach/water/flooded,
/area/precursor)
"g" = (
/obj/random/medical/low_chance,
/turf/simulated/floor/beach/water/flooded,
/area/precursor)
"h" = (
/turf/simulated/wall,
/area/precursor)
"i" = (
/obj/effect/window_lwall_spawn/smartspawn,
/turf/simulated/floor/plating,
/area/precursor)
"j" = (
/obj/random/cluster/psi_monster,
/turf/simulated/floor/beach/water/flooded,
/area/precursor)
"k" = (
/obj/structure/table/standard,
/obj/random/surgery_tool,
/obj/random/surgery_tool/low_chance,
/obj/item/tool/medmultitool,
/turf/simulated/floor/rusted/panels,
/area/precursor)
"l" = (
/obj/machinery/optable,
/turf/simulated/floor/rusted/panels,
/area/precursor)
"m" = (
/turf/simulated/floor/rusted/panels,
/area/precursor)
"o" = (
/turf/simulated/floor/rusted/techfloor_grid,
/area/precursor)
"p" = (
/obj/structure/table/standard,
/obj/random/contraband/low_chance,
/obj/random/contraband/low_chance,
/turf/simulated/floor/tiled/white/brown_perforated,
/area/precursor)
"q" = (
/obj/structure/medical_stand,
/turf/simulated/floor/tiled/white/brown_perforated,
/area/precursor)
"r" = (
/turf/simulated/floor/beach/water/flooded,
/area/precursor)
"s" = (
/obj/machinery/light/small{
	dir = 1
	},
/turf/simulated/floor/beach/water/flooded,
/area/precursor)
"v" = (
/obj/random/mob/psi_monster/low_chance,
/turf/simulated/floor/rusted/panels,
/area/precursor)
"w" = (
/turf/simulated/wall/rust_standard,
/area/precursor)
"x" = (
/obj/effect/window_lwall_spawn/smartspawn,
/obj/structure/low_wall/rusted,
/turf/simulated/floor/plating,
/area/precursor)
"C" = (
/obj/random/cluster/psi_monster/low_chance,
/turf/simulated/floor/beach/water/flooded,
/area/precursor)
"I" = (
/obj/structure/table/standard,
/obj/random/surgery_tool,
/obj/random/surgery_tool/low_chance,
/obj/random/pouch/low_chance,
/turf/simulated/floor/tiled/white/panels,
/area/precursor)
"O" = (
/obj/structure/table/standard,
/obj/random/dungeon_gun_ballistic/low_chance,
/obj/random/pouch/low_chance,
/turf/simulated/floor/beach/water/flooded,
/area/precursor)
"Q" = (
/obj/random/mob/psi_monster/low_chance,
/turf/simulated/floor/beach/water/flooded,
/area/precursor)
"V" = (
/obj/structure/medical_stand,
/turf/simulated/floor/beach/water/flooded,
/area/precursor)

(1,1,1) = {"
r
r
r
r
r
a
Q
r
a
a
a
"}
(2,1,1) = {"
Q
w
h
r
r
h
h
w
w
p
r
"}
(3,1,1) = {"
r
b
i
f
f
i
k
m
w
q
r
"}
(4,1,1) = {"
r
b
x
g
r
i
l
v
o
r
r
"}
(5,1,1) = {"
r
b
x
r
r
x
x
x
w
s
r
"}
(6,1,1) = {"
r
c
x
j
r
a
a
a
a
C
r
"}
(7,1,1) = {"
r
d
i
r
a
i
i
i
w
s
r
"}
(8,1,1) = {"
r
e
x
r
r
x
l
m
r
r
r
"}
(9,1,1) = {"
r
e
x
r
r
x
I
Q
r
V
r
"}
(10,1,1) = {"
Q
w
w
r
a
w
r
r
r
O
r
"}
(11,1,1) = {"
r
r
r
r
r
r
Q
r
r
r
r
"}
