//MAP CONVERTED BY dmm2tgm.py THIS HEADER COMMENT PREVENTS RECONVERSION, DO NOT REMOVE
"a" = (
/turf/simulated/floor/beach/water/shallow,
/area/precursor)
"b" = (
/obj/random/traps,
/turf/simulated/floor/beach/water/shallow,
/area/precursor)
"c" = (
/turf/simulated/wall,
/area/precursor)
"d" = (
/obj/machinery/door/firedoor,
/obj/effect/window_lwall_spawn/smartspawn,
/turf/simulated/floor/plating,
/area/precursor)
"e" = (
/obj/structure/table/standard,
/obj/item/paper_bin,
/turf/simulated/floor/beach/water/shallow,
/area/precursor)
"f" = (
/obj/structure/table/standard,
/obj/item/device/lighting/toggleable/lamp,
/turf/simulated/floor/beach/water/shallow,
/area/precursor)
"g" = (
/obj/structure/reagent_dispensers/water_cooler,
/turf/simulated/floor/beach/water/shallow,
/area/precursor)
"h" = (
/obj/structure/table/standard,
/obj/random/pack/rare/low_chance,
/obj/random/lowkeyrandom,
/obj/random/lowkeyrandom,
/obj/random/lowkeyrandom,
/turf/simulated/floor/beach/water/shallow,
/area/precursor)
"i" = (
/obj/structure/bed/chair/office/dark{
	dir = 1
	},
/turf/simulated/floor/beach/water/shallow,
/area/precursor)
"j" = (
/obj/structure/bed/chair/office/dark{
	dir = 4
	},
/turf/simulated/floor/beach/water/shallow,
/area/precursor)
"k" = (
/obj/structure/table/standard,
/obj/random/pack/gun_loot/low_chance,
/obj/random/lowkeyrandom,
/turf/simulated/floor/beach/water/shallow,
/area/precursor)
"m" = (
/obj/structure/table/standard,
/obj/random/powercell/low_chance,
/obj/random/lowkeyrandom,
/turf/simulated/floor/beach/water/shallow,
/area/precursor)
"p" = (
/obj/structure/bed/chair/office/dark,
/turf/simulated/floor/beach/water/shallow,
/area/precursor)
"q" = (
/obj/random/cluster/psi_monster/low_chance,
/turf/simulated/floor/beach/water/shallow,
/area/precursor)
"r" = (
/obj/machinery/light/small{
	dir = 4;
	pixel_y = 0
	},
/turf/simulated/floor/beach/water/shallow,
/area/precursor)
"s" = (
/obj/machinery/light/small{
	dir = 8
	},
/turf/simulated/floor/beach/water/shallow,
/area/precursor)
"u" = (
/obj/random/mob/psi_monster/low_chance,
/turf/simulated/floor/beach/water/shallow,
/area/precursor)
"S" = (
/obj/structure/bed/chair/office/dark,
/obj/random/mob/psi_monster/low_chance,
/turf/simulated/floor/beach/water/shallow,
/area/precursor)

(1,1,1) = {"
a
u
a
a
a
a
a
b
a
a
a
"}
(2,1,1) = {"
b
c
c
c
c
d
c
c
c
c
b
"}
(3,1,1) = {"
a
d
e
h
a
q
a
h
e
d
a
"}
(4,1,1) = {"
a
d
f
i
a
a
r
S
f
d
a
"}
(5,1,1) = {"
a
c
c
c
c
a
c
c
c
c
u
"}
(6,1,1) = {"
u
d
e
h
a
a
a
h
e
d
a
"}
(7,1,1) = {"
a
d
f
i
a
u
r
p
f
d
a
"}
(8,1,1) = {"
a
c
c
c
c
a
c
c
c
c
a
"}
(9,1,1) = {"
a
c
g
j
a
a
s
j
g
c
a
"}
(10,1,1) = {"
a
c
f
k
m
b
m
k
f
c
a
"}
(11,1,1) = {"
u
a
a
a
a
a
u
a
a
a
u
"}
