//MAP CONVERTED BY dmm2tgm.py THIS HEADER COMMENT PREVENTS RECONVERSION, DO NOT REMOVE
"a" = (
/turf/simulated/floor/tiled/dark/danger,
/area/precursor)
"b" = (
/obj/random/junk,
/turf/simulated/floor/tiled/dark/danger,
/area/precursor)
"d" = (
/turf/simulated/floor/tiled/dark/cargo,
/area/precursor)
"e" = (
/turf/simulated/floor/beach/water/swamp,
/area/precursor)
"f" = (
/obj/random/pack/tech_loot/low_chance,
/turf/simulated/floor/beach/water/swamp,
/area/precursor)
"g" = (
/obj/structure/catwalk,
/obj/random/mob/psi_monster/low_chance,
/turf/simulated/floor/beach/water/swamp,
/area/precursor)
"h" = (
/obj/random/cluster/psi_monster/low_chance,
/turf/simulated/floor/beach/water/swamp,
/area/precursor)
"i" = (
/obj/machinery/deployable/barrier,
/turf/simulated/floor/beach/water/swamp,
/area/precursor)
"j" = (
/obj/structure/girder,
/turf/simulated/floor/beach/water/swamp,
/area/precursor)
"k" = (
/obj/structure/catwalk,
/obj/structure/barricade,
/turf/simulated/floor/beach/water/swamp,
/area/precursor)
"l" = (
/turf/simulated/wall/rust_reinforced,
/area/precursor)
"m" = (
/obj/effect/window_lwall_spawn/plasma,
/obj/machinery/door/blast/regular{
	_wifi_id = null;
	icon_state = "pdoor1";
	id = null;
	name = "Reactor Core";
	p_open = 0
	},
/obj/structure/low_wall/rusted,
/turf/simulated/floor/plating,
/area/precursor)
"n" = (
/obj/random/pack/rare,
/turf/simulated/floor/reinforced{
	name = "engine floor";
	oxygen = 0
	},
/area/precursor)
"o" = (
/obj/random/mob/psi_monster/low_chance,
/turf/simulated/floor/reinforced{
	name = "engine floor";
	oxygen = 0
	},
/area/precursor)
"p" = (
/obj/random/junk,
/turf/simulated/floor/beach/water/swamp,
/area/precursor)
"q" = (
/obj/random/psi_megafauna,
/obj/machinery/artifact,
/turf/simulated/floor/reinforced{
	name = "engine floor";
	oxygen = 0
	},
/area/precursor)
"r" = (
/obj/effect/window_lwall_spawn/plasma,
/obj/machinery/door/blast/regular{
	_wifi_id = null;
	icon_state = "pdoor1";
	id = null;
	name = "Reactor Core";
	p_open = 0
	},
/obj/structure/low_wall/rusted,
/turf/simulated/floor/reinforced,
/area/precursor)
"t" = (
/obj/structure/barricade,
/turf/simulated/floor/beach/water/swamp,
/area/precursor)
"u" = (
/obj/structure/girder/displaced,
/turf/simulated/floor/beach/water/swamp,
/area/precursor)
"R" = (
/obj/random/cluster/psi_monster/low_chance,
/turf/simulated/floor/tiled/dark/danger,
/area/precursor)

(1,1,1) = {"
a
a
p
e
e
p
d
a
b
e
h
"}
(2,1,1) = {"
b
e
e
f
e
g
p
f
p
e
e
"}
(3,1,1) = {"
a
e
i
j
i
k
j
u
t
f
p
"}
(4,1,1) = {"
b
f
i
l
l
r
l
l
j
f
e
"}
(5,1,1) = {"
e
e
j
l
n
o
n
l
u
p
d
"}
(6,1,1) = {"
e
g
k
m
o
q
o
m
k
g
d
"}
(7,1,1) = {"
d
p
j
l
n
o
n
l
u
p
d
"}
(8,1,1) = {"
a
e
j
l
l
m
l
l
j
f
b
"}
(9,1,1) = {"
b
f
i
j
j
k
t
j
j
p
a
"}
(10,1,1) = {"
R
e
e
f
p
g
e
f
e
f
e
"}
(11,1,1) = {"
p
e
a
b
d
e
e
a
b
e
e
"}
