//MAP CONVERTED BY dmm2tgm.py THIS HEADER COMMENT PREVENTS RECONVERSION, DO NOT REMOVE
"a" = (
/turf/unsimulated/floor/snow,
/area/precursor)
"b" = (
/turf/simulated/wall,
/area/precursor)
"c" = (
/obj/machinery/light/small{
	dir = 4;
	pixel_y = 0
	},
/turf/unsimulated/floor/snow,
/area/precursor)
"d" = (
/obj/machinery/door/airlock{
	name = "Unisex Restrooms"
	},
/turf/simulated/floor/tiled/steel,
/area/precursor)
"e" = (
/obj/machinery/light/small{
	dir = 8
	},
/turf/unsimulated/floor/snow,
/area/precursor)
"f" = (
/obj/machinery/recharge_station,
/obj/machinery/light/small,
/turf/simulated/floor/tiled/steel,
/area/precursor)
"g" = (
/obj/machinery/door/airlock/maintenance_common{
	name = "Service Maintenance";
	req_access = list(12)
	},
/turf/unsimulated/floor/snow,
/area/precursor)
"h" = (
/obj/machinery/door/firedoor,
/obj/machinery/door/airlock{
	name = "Unisex Restrooms"
	},
/turf/simulated/floor/tiled/steel/cargo,
/area/precursor)
"i" = (
/turf/simulated/floor/snow,
/area/precursor)
"j" = (
/obj/random/pack/rare/low_chance,
/turf/unsimulated/floor/snow,
/area/precursor)
"k" = (
/obj/structure/table/rack,
/obj/random/pack/tech_loot,
/obj/random/pack/tech_loot,
/obj/random/pack/tech_loot/low_chance,
/obj/random/pack/tech_loot/low_chance,
/obj/random/pouch/low_chance,
/turf/simulated/floor/tiled/steel/panels,
/area/precursor)
"l" = (
/obj/random/mob/psi_monster/low_chance,
/obj/machinery/light/small{
	dir = 8
	},
/turf/simulated/floor/tiled/steel/panels,
/area/precursor)
"m" = (
/obj/structure/toilet{
	dir = 4
	},
/obj/random/pack/rare/low_chance,
/obj/random/pack/rare/low_chance,
/obj/random/pack/rare/low_chance,
/obj/random/mob/psi_monster/low_chance,
/obj/machinery/light/small,
/turf/simulated/floor/tiled/steel,
/area/precursor)
"n" = (
/obj/random/cluster/psi_monster/lower_chance,
/turf/unsimulated/floor/snow,
/area/precursor)
"o" = (
/obj/structure/table/rack,
/obj/random/pack/gun_loot,
/obj/random/pack/gun_loot/low_chance,
/obj/random/pack/gun_loot/low_chance,
/obj/random/powercell/low_chance,
/turf/simulated/floor/tiled/steel/panels,
/area/precursor)
"p" = (
/obj/structure/toilet{
	dir = 4
	},
/obj/random/common_oddities/low_chance,
/obj/random/pack/rare/low_chance,
/obj/random/mob/psi_monster/low_chance,
/obj/machinery/light/small,
/turf/simulated/floor/tiled/steel,
/area/precursor)
"q" = (
/turf/simulated/floor/beach/water/ice,
/area/precursor)
"r" = (
/obj/structure/sink{
	dir = 4;
	icon_state = "sink";
	pixel_x = 11;
	pixel_y = 0
	},
/obj/structure/mirror{
	dir = 8;
	pixel_x = 28;
	pixel_y = 0
	},
/turf/simulated/floor/beach/water/ice,
/area/precursor)
"u" = (
/turf/simulated/wall/rust_standard,
/area/precursor)
"v" = (
/obj/structure/sink{
	dir = 4;
	icon_state = "sink";
	pixel_x = 11;
	pixel_y = 0
	},
/obj/structure/mirror{
	dir = 8;
	pixel_x = 28;
	pixel_y = 0
	},
/obj/random/ammo_fancy,
/turf/simulated/floor/beach/water/ice,
/area/precursor)
"x" = (
/obj/machinery/light/small,
/turf/unsimulated/floor/snow,
/area/precursor)
"z" = (
/obj/random/cluster/psi_monster/lower_chance,
/turf/simulated/floor/snow,
/area/precursor)
"B" = (
/obj/structure/flora/small/snow/rock4,
/turf/unsimulated/floor/snow,
/area/precursor)
"C" = (
/obj/item/storage/hcases/ammo/blackmarket,
/obj/random/dungeon_gun_mods,
/turf/simulated/floor/beach/water/ice,
/area/precursor)
"D" = (
/obj/structure/flora/small/snow/rock4,
/turf/simulated/floor/snow,
/area/precursor)
"E" = (
/obj/structure/flora/small/snow/rock7,
/turf/unsimulated/floor/snow,
/area/precursor)
"F" = (
/obj/structure/flora/small/snow/rock2,
/turf/unsimulated/floor/snow,
/area/precursor)
"H" = (
/obj/machinery/light/small{
	dir = 1
	},
/turf/unsimulated/floor/snow,
/area/precursor)
"I" = (
/obj/structure/toilet{
	dir = 4
	},
/obj/random/common_oddities/low_chance,
/obj/random/pack/rare/low_chance,
/obj/item/ammo_kit,
/obj/random/mob/psi_monster/low_chance,
/obj/machinery/light/small,
/turf/simulated/floor/tiled/steel,
/area/precursor)
"L" = (
/obj/random/mob/psi_monster/low_chance,
/obj/machinery/light/small,
/turf/unsimulated/floor/snow,
/area/precursor)
"N" = (
/obj/structure/sink{
	dir = 4;
	icon_state = "sink";
	pixel_x = 11;
	pixel_y = 0
	},
/obj/structure/mirror{
	dir = 8;
	pixel_x = 28;
	pixel_y = 0
	},
/obj/random/dungeon_ammo,
/turf/simulated/floor/beach/water/ice,
/area/precursor)
"P" = (
/obj/random/psi_megafauna,
/turf/simulated/floor/snow,
/area/precursor)
"S" = (
/obj/random/mob/psi_monster/low_chance,
/turf/unsimulated/floor/snow,
/area/precursor)
"T" = (
/obj/structure/table/rack,
/obj/random/pack/tech_loot,
/obj/random/pack/tech_loot,
/obj/random/pack/tech_loot/low_chance,
/obj/random/pack/tech_loot/low_chance,
/obj/random/powercell/low_chance,
/turf/unsimulated/floor/snow,
/area/precursor)
"W" = (
/obj/random/mob/psi_monster/low_chance,
/obj/machinery/light/small,
/turf/simulated/floor/beach/water/ice,
/area/precursor)
"X" = (
/obj/machinery/light/small{
	dir = 8
	},
/obj/structure/flora/small/snow/boulder1,
/turf/simulated/floor/snow,
/area/precursor)
"Y" = (
/obj/structure/flora/small/snow/rock6,
/turf/unsimulated/floor/snow,
/area/precursor)
"Z" = (
/obj/random/dungeon_ammo,
/turf/simulated/floor/beach/water/ice,
/area/precursor)

(1,1,1) = {"
a
c
B
a
a
S
a
a
n
c
a
"}
(2,1,1) = {"
a
b
u
u
u
u
b
b
b
u
B
"}
(3,1,1) = {"
a
b
f
u
m
b
I
u
p
u
a
"}
(4,1,1) = {"
x
u
h
u
h
b
h
u
h
b
H
"}
(5,1,1) = {"
a
d
a
e
i
i
i
X
i
u
E
"}
(6,1,1) = {"
L
b
j
n
D
P
i
i
z
u
a
"}
(7,1,1) = {"
a
u
u
u
u
b
Z
q
q
u
S
"}
(8,1,1) = {"
a
u
k
l
o
b
C
Z
W
u
a
"}
(9,1,1) = {"
a
b
k
S
T
b
v
r
N
b
a
"}
(10,1,1) = {"
a
u
u
g
u
u
b
u
b
b
a
"}
(11,1,1) = {"
F
a
e
a
e
a
S
a
a
e
Y
"}
