"a" = (/turf/simulated/floor/rock/dark,/area/precursor)
"c" = (/mob/living/simple_animal/light_geist,/turf/simulated/floor/rock/dark,/area/precursor)

(1,1,1) = {"
aaaaaaaaaaa
aaaaaaaaaaa
aaaaaaaaaaa
aaaaaaaaaaa
aaaaaaaaaaa
aaaaacaaaaa
aaaaaaaaaaa
aaaaaaaaaaa
aaaaaaaaaaa
aaaaaaaaaaa
aaaaaaaaaaa
"}
