//MAP CONVERTED BY dmm2tgm.py THIS HEADER COMMENT PREVENTS RECONVERSION, DO NOT REMOVE
"a" = (
/turf/simulated/floor/beach/sand/desert,
/area/deepmaint)
"c" = (
/obj/machinery/floodlight{
	on = 1
	},
/turf/simulated/floor/rock/manmade/ruin1,
/area/deepmaint)
"g" = (
/obj/effect/overlay/palmtree_l,
/turf/simulated/floor/beach/sand/desert,
/area/deepmaint)
"i" = (
/obj/effect/overlay/palmtree_r,
/obj/effect/decal/cleanable/rubble,
/turf/simulated/floor/beach/sand/desert,
/area/deepmaint)
"n" = (
/obj/item/stool,
/turf/simulated/floor/rock/manmade/ruin1,
/area/deepmaint)
"o" = (
/obj/effect/decal/cleanable/rubble,
/turf/simulated/floor/beach/sand/desert,
/area/deepmaint)
"q" = (
/obj/effect/decal/cleanable/rubble,
/turf/simulated/wall/tomb_king,
/area/deepmaint)
"s" = (
/obj/effect/decal/cleanable/rubble,
/turf/simulated/floor/rock/manmade/ruin1,
/area/deepmaint)
"u" = (
/obj/structure/sink/puddle,
/turf/simulated/floor/beach/sand/desert,
/area/deepmaint)
"v" = (
/obj/structure/table/reinforced,
/obj/item/gun/energy/cog,
/obj/item/cell/medium/super,
/turf/simulated/floor/rock/manmade/ruin1,
/area/deepmaint)
"D" = (
/turf/simulated/wall/tomb_king,
/area/deepmaint)
"H" = (
/obj/structure/table/reinforced,
/obj/item/device/lighting/toggleable/flashlight/heavy,
/obj/item/storage/bag/fossils,
/obj/item/tool/pickaxe/excavation,
/turf/simulated/floor/rock/manmade/ruin1,
/area/deepmaint)
"L" = (
/mob/living/simple_animal/lizard{
	name = "lumbo"
	},
/turf/simulated/floor/beach/sand/desert,
/area/deepmaint)
"M" = (
/turf/simulated/floor/rock/manmade/ruin1,
/area/deepmaint)
"S" = (
/obj/structure/flora/small/grassa1,
/turf/simulated/floor/beach/sand/desert,
/area/deepmaint)
"X" = (
/obj/effect/overlay/palmtree_l,
/obj/structure/flora/small/grassa1,
/turf/simulated/floor/beach/sand/desert,
/area/deepmaint)
"Y" = (
/obj/structure/table/reinforced,
/obj/item/device/depth_scanner,
/obj/item/device/ano_scanner,
/turf/simulated/floor/rock/manmade/ruin1,
/area/deepmaint)
"Z" = (
/obj/structure/table/reinforced,
/turf/simulated/floor/rock/manmade/ruin1,
/area/deepmaint)

(1,1,1) = {"
M
M
M
M
M
M
M
M
s
s
M
M
M
"}
(2,1,1) = {"
M
M
M
M
M
M
g
D
q
s
M
M
M
"}
(3,1,1) = {"
M
M
n
v
M
M
u
a
s
s
M
c
M
"}
(4,1,1) = {"
M
H
Z
Y
M
M
M
M
M
M
M
M
M
"}
(5,1,1) = {"
M
M
M
M
M
M
M
M
M
M
M
M
M
"}
(6,1,1) = {"
s
s
M
M
M
M
M
M
s
s
a
a
X
"}
(7,1,1) = {"
i
o
a
s
s
s
M
M
s
o
L
a
a
"}
(8,1,1) = {"
a
a
a
o
s
s
M
M
s
o
g
D
D
"}
(9,1,1) = {"
a
D
g
o
s
s
M
M
M
S
a
q
q
"}
(10,1,1) = {"
D
D
D
a
M
M
M
M
M
M
M
s
s
"}
(11,1,1) = {"
D
D
a
g
M
M
M
M
M
M
M
M
M
"}
