//MAP CONVERTED BY dmm2tgm.py THIS HEADER COMMENT PREVENTS RECONVERSION, DO NOT REMOVE
"a" = (
/turf/simulated/floor/beach/sand/desert,
/area/precursor)
"c" = (
/obj/machinery/floodlight{
	on = 1
	},
/turf/simulated/floor/rock/manmade/ruin1,
/area/precursor)
"g" = (
/obj/effect/overlay/palmtree_l,
/turf/simulated/floor/beach/sand/desert,
/area/precursor)
"i" = (
/obj/effect/overlay/palmtree_r,
/obj/effect/decal/cleanable/rubble,
/turf/simulated/floor/beach/sand/desert,
/area/precursor)
"n" = (
/obj/item/stool,
/turf/simulated/floor/rock/manmade/ruin1,
/area/precursor)
"o" = (
/obj/effect/decal/cleanable/rubble,
/turf/simulated/floor/beach/sand/desert,
/area/precursor)
"q" = (
/obj/effect/decal/cleanable/rubble,
/turf/simulated/wall/tomb_king,
/area/precursor)
"s" = (
/obj/effect/decal/cleanable/rubble,
/turf/simulated/floor/rock/manmade/ruin1,
/area/precursor)
"u" = (
/obj/structure/sink/puddle,
/turf/simulated/floor/beach/sand/desert,
/area/precursor)
"v" = (
/obj/structure/table/reinforced,
/obj/item/gun/energy/cog,
/obj/item/cell/medium/super,
/turf/simulated/floor/rock/manmade/ruin1,
/area/precursor)
"D" = (
/turf/simulated/wall/tomb_king,
/area/precursor)
"H" = (
/obj/structure/table/reinforced,
/obj/item/device/lighting/toggleable/flashlight/heavy,
/obj/item/storage/bag/fossils,
/obj/item/tool/pickaxe/excavation,
/turf/simulated/floor/rock/manmade/ruin1,
/area/precursor)
"L" = (
/obj/machinery/artifact_scanpad/precursor,
/turf/simulated/floor/rock/manmade/ruin1,
/area/precursor)
"M" = (
/turf/simulated/floor/rock/manmade/ruin1,
/area/precursor)
"S" = (
/obj/structure/flora/small/grassa1,
/turf/simulated/floor/beach/sand/desert,
/area/precursor)
"X" = (
/obj/effect/overlay/palmtree_l,
/obj/structure/flora/small/grassa1,
/turf/simulated/floor/beach/sand/desert,
/area/precursor)
"Y" = (
/obj/structure/table/reinforced,
/obj/item/device/depth_scanner,
/obj/item/device/ano_scanner,
/turf/simulated/floor/rock/manmade/ruin1,
/area/precursor)
"Z" = (
/obj/structure/table/reinforced,
/turf/simulated/floor/rock/manmade/ruin1,
/area/precursor)

(1,1,1) = {"
M
M
M
M
M
M
M
M
s
s
M
M
M
"}
(2,1,1) = {"
M
M
M
M
M
M
g
M
s
s
M
M
M
"}
(3,1,1) = {"
M
M
n
v
M
M
u
a
s
s
M
c
M
"}
(4,1,1) = {"
M
H
Z
Y
M
M
M
M
M
M
M
M
M
"}
(5,1,1) = {"
M
M
M
M
M
M
M
M
M
M
M
M
M
"}
(6,1,1) = {"
s
s
M
M
M
M
L
M
s
s
a
a
X
"}
(7,1,1) = {"
i
o
a
s
s
s
M
M
s
o
a
a
a
"}
(8,1,1) = {"
a
a
a
o
s
s
M
M
s
o
g
D
D
"}
(9,1,1) = {"
a
D
g
o
s
s
M
M
M
S
a
q
q
"}
(10,1,1) = {"
D
D
D
a
M
M
M
M
M
M
M
s
s
"}
(11,1,1) = {"
D
D
a
g
M
M
M
M
M
M
M
M
M
"}
